WE ./path_to_the_west_texture


C 225,30,0



F 220   ,    100  ,   0



       EA ./path_to_the_east_texture

    NO      ./path_to_the_north_texture

SO    ./path_to_the_south_texture






        1111111111111111111111111
1000000000110000000000001
         1011000001110000000000001
         1001000000000000000000001
1111111110110000011100100000000001 
1000000000110000011101 111111111111    
1111111111111111111111111 
  1111111111111111111111111
11110111111111011100000010001
11110111111111011101010010001
11000000110101011100000010001
10000000000000001100000010001
10000000000000001101010010101
11000001110101011111011111N10111
11110111 1110101 101111010101
11111111 1111111 111111111111




