WE ./textures/west.xpm

NO ./textures/north.xpm



SO ./textures/south.xpm


C 31,0,200


F    22 ,31, 1
 EA  ./textures/east.xpm





1111111111111111111111111
1000000000110000000000001
1011000001110000000000001
100100000000000000000000111111111
1111111110110000011100000000000011
100000000011000001110111111111111
11110111111111011100000010001
1111111111111111111111111111111111
1111111111111111111111111111111111
11110111111111011101010010001
1100000011010101110000010001
100000000000001011000N0010001
100000000000010001101010010001
1100000111010101111101111000111
11110111 11101011101111010001
11111111 1111111 111111111111
