WE ./textures/west.xpm

    NO      ./textures/north.xpm

   SO ./textures/south.xpm

C 1, 23 , 223 


     F 8   ,   255, 222


       EA  ./textures/east.xpm




        1111111111111111111111111
        1000000000110000000000001
        1011000001110000000000001
        1001000000000000000000001
1111111110110000011100000000000011
100000000011000001110111111111111
11110111111111011100000010001
11110111111111011101010010001        1
1100000011010101110000010001        1N1
10000000000000001100000010001        1
100000000000000001101010010001
1100000111010101111101111000111
11110111 11101011101111010001
11111111 1111111 111111111111


